0 0 0 0 0 0 0 0 0 0 0 0 0 0 0 0 0 0 0 0
0 13 1 1 1 1 1 1 1 1 1 1 1 1 1 1 1 1 1 0
0 1 1 1 1 1 1 1 1 1 1 1 1 1 1 1 1 1 0 0
0 1 1 1 1 1 1 1 1 1 1 1 1 1 1 1 1 1 0 0
0 1 1 1 1 1 1 1 1 1 1 1 1 50 -1 -1 -1 1 1 0
0 1 1 1 1 1 1 1 1 1 1 1 1 -1 -1 -1 -1 -1 1 0
0 1 1 1 1 1 1 1 1 1 1 1 1 -1 -1 -1 -1 -1 1 0
0 1 1 1 1 1 1 1 1 1 1 1 1 1 -1 -1 -1 1 1 0
0 1 1 1 1 1 1 1 1 0 0 1 1 1 -1 52 -1 1 1 0
0 1 1 1 1 1 1 1 1 1 1 1 1 1 1 1 1 1 1 0
0 1 1 1 1 1 1 1 0 0 1 1 1 1 1 1 1 1 1 0
0 1 1 1 1 1 1 1 0 0 1 1 1 1 1 1 1 -11 1 0
0 1 1 1 1 0 0 1 1 1 1 1 1 1 1 1 1 1 1 0
0 0 0 0 0 0 0 1 0 0 0 0 0 0 0 0 0 0 0 0
0 1 1 1 1 1 1 1 1 1 1 1 1 1 1 1 1 1 1 0
0 1 1 1 1 1 1 1 1 1 1 1 1 1 1 1 1 1 1 0
0 1 1 1 1 1 1 1 1 1 1 1 1 1 1 1 1 1 1 0
0 1 1 1 1 1 1 1 1 1 1 1 1 1 1 1 1 1 0 0
0 1 1 1 1 1 1 1 1 1 1 1 1 1 1 1 1 1 0 0
0 0 0 0 0 0 0 0 0 0 0 0 10 0 0 0 0 0 0 0